11111111111111111111
12000000000010000011
11111111111011101011
10000010001000101011
10101110101110101111
10101000100000100011
11101011111111101011
10001000100010001011
10101110101010111011
10100010101010101011
10111110101110101011
10000000100000001011
10111111101111111011
10000000100010000011
11111110111010111011
10000010001010101011
10111011101110101011
10001000000000100311
11111111111111111111
11111111111111111111